His	His	组氨酸
Ile	Ile	异亮氨酸
Val	Val	缬氨酸
Asp	Asp	天门冬氨酸
Asn	Asn	天冬酰胺
Thr	Thr	苏氨酸
Ser	Ser	丝氨酸 
Trp	Trp	色氨酸
Pro	Pro	脯氨酸
Leu	Leu	亮氨酸 
Tyr	Tyr	酪氨酸
Lys	Lys	赖氨酸
Arg	Arg	精氨酸
Gln	Gln	谷氨酰胺
Glu	Glu	谷氨酸
Gly	Gly	甘氨酸
Met	Met	蛋氨酸
Ala	Ala	丙氨酸
Phe	Phe	苯丙氨酸 
Cys	Cys	半胱氨酸
SeC	SeC	硒半胱氨酸
Ile2	Ile	特异性异亮氨酸
fMet	Met	甲酰蛋氨酸
Sup	NA	NA
